SAV = "countries/Savannah.txt"
UNH = "countries/United_Holds.txt"
TPA = "countries/The_Pie_Army.txt"
CJA = "countries/Cajinstan.txt"
HEX = "countries/Hexis.txt"
VDR = "countries/The_Light_Side.txt"
LON = "countries/Lonevillia.txt"
TRE = "countries/Tree.txt"
GRA = "countries/Grandis.txt"
GLU = "countries/Gluck.txt"
LOR = "countries/Lorigan.txt"
KAA = "countries/KaBaa.txt"
LBV = "countries/la_belle_vie.txt"
TMP = "countries/Temple.txt"
NGT = "countries/Night_Warriors.txt"
NWR = "countries/Newer_Arabia.txt"
APQ = "countries/ASSPEEQUEARE.txt"
FKT = "countries/FreakTopia.txt"
ZLT = "countries/Zillerton"
ATU = "countries/Atuo.txt"
ADF = "countries/Alderfen.txt"
TRS = "countries/True_Serbia.txt"
GOR = "countries/GORGON.txt"
BLL = "countries/Bull_Land.txt"
LNC = "countries/Longcord.txt"
SPS = "countries/Shapirostan.txt"
EZR = "countries/Easy_Rider.txt"
AKD = "countries/Akhund.txt"
GTK = "countries/Greater_Temasik.txt"
NTB = "countries/Northern_Borneo.txt"
NZL = "countries/Naziland_II.txt"
LTP = "countries/Loatiop.txt"
GGS = "countries/Girl_Gamerstan.txt"
BIS = "countries/Bismarck.txt"
USR = "countries/USRSA.txt"
JIH = "countries/Jihadistan.txt"
BSS = "countries/Ba-Sing-Se.txt"
ROD = "countries/Rodents.txt"
TSA = "countries/The_Sanctum.txt"
VIN = "countries/Vintas.txt"
TEU = "countries/Teutonic_Order.txt"
NIK = "countries/Nikkem.txt"
OUY = "countries/Ouyashima.txt"
WAF = "countries/Wafsky.txt"
LEN = "countries/Leninstan.txt"
BRL = "countries/Brickland.txt"
SPO = "countries/Spolia.txt"
AAF = "countries/Alpha_Fury.txt"
VAL = "countries/Valdor.txt"
CHB = "countries/Chickenbake.txt"
DER = "countries/Deerhaven.txt"
MEL = "countries/Melanga.txt"
PAR = "countries/Parsistan.txt"
POI = "countries/People_of_India.txt"
UNN = "countries/United_Nigeria.txt"
TAJ = "countries/Tanjavur.txt"
NAD = "countries/Nadif_Land.txt"
MAL = "countries/Malstasia.txt"
NCS = "countries/NCIS.txt"
KHA = "countries/Khabranth.txt"
PPS = "countries/Pilipino_State.txt"
NGR = "countries/Nigeria_Rep.txt"
JAD = "countries/Jadentopia.txt"
ARR = "countries/Arewa_Republic.txt"
GPE = "countries/GPE.txt"
NEO = "countries/Neo-Assyria.txt"
TAE = "countries/TheAnimeEmpire.txt"
SAS = "countries/Sasania.txt"
OFA = "countries/Old_Florida.txt"
BLS = "countries/Bless.txt"
SNA = "countries/SevenNationArmy.txt"
RET = "countries/Retrastan.txt"
ATO = "countries/Automia.txt"
KIO = "countries/Kiokci.txt"
TYG = "countries/Tygrania.txt"
REV = "countries/Revenezuela.txt"
TOL = "countries/The_Oatlands.txt"
TAD = "countries/Taira_Daimyo.txt"
CPR = "countries/Cyprus_The_2st.txt"
KWN = "countries/KawaiiNation.txt"
MOL = "countries/MoorLand.txt"
CHN = "countries/Chola_Naadu.txt"
OBE = "countries/Obelistao.txt"
BLA = "countries/Blackistan.txt"
VAR = "countries/Varda.txt"
KIN = "countries/Kinghts.txt"
MAR = "countries/Marnam.txt"
CWL = "countries/"CWLA.txt"
ARY = "countries/Aryana.txt"
NUL = "countries/nuln.txt"
CHR = "countries/Christia.txt"
GOG = "countries/Gold_Gears.txt"
KUB = "countries/Kubise.txt"
CAN = "countries/Canadas.txt"
NCP = "countries/Nice_People.txt"
WAL = "countries/Waldensia.txt"
HGE = "countries/Helghan_Empire.txt"
UPS = "countries/Upper_Slabonia.txt"
JUK = "countries/Jukovanje.txt"
LES = "countries/Leswaynia.txt"
FRE = "countries/Freedocracy.txt"
GYP = "countries/Gypsy_Prussians.txt"
CSA = "countries/CSA.txt"
ARI = "countries/Ariania.txt"
MLT = "countries/molotovia.txt"
MOC = "countries/Mocambique.txt"
TEA = "countries/tea.txt"
LUD = "countries/Lunar_Diplomacy.txt"
UTO = "countries/Utopia.txt"
TER = "countries/Terzia.txt"
TRO = "countries/Tropicali.txt"
WHS = "countries/WhiteStuff.txt"
NEI = "countries/New_India.txt"
SOR = "countries/Sorann.txt"
EYT = "countries/EYT.txt"
MEZ = "countries/Mezopotamya.txt"
DPR = "countries/DPRI.txt"
PRA = "countries/Praieras.txt"
GRI = "countries/Greater_Iran.txt"
ROS = "countries/Rosovski.txt"
CAR = "countries/Cartiga.txt"
MAK = "countries/Makasta.txt"
SKA = "countries/Skaro.txt"
MID = "countries/MidgardLand.txt"
MOO = "countries/Moostang.txt"
SAT = "countries/Saint_Torong.txt"
KNG = "countries/Kinglaund.txt"
GRG = "countries/Grigoriy.txt"
BRE = "countries/Brendapolis.txt"
KOL = "countries/Kolian.txt"
LIF = "countries/Liftopia.txt"
SIM = "countries/Sierra_Madre.txt"
HIS = "countries/Hispanav.txt"
RPB = "countries/RPdo_Brasil.txt"
NAN = "countries/Nanculombia.txt"
RIC = "countries/rice.txt"
THV = "countries/TheVoid.txt"
LUP = "countries/Luna_Plutonem.txt"
PLE = "countries/Polenta.txt"
HAM = "countries/Hamid.txt"